{
	"rows": 19,
	"cols": 18,
	"playerSpawnX": 2,
	"playerSpawnY": 9,
	"goalX": 15,
	"goalY": 18,
    "blueprint": [
		[ 0, 0, 0, 0, 0, 0, 0, 2, 0, 0, 2, 0, 0, 0, 0, 0, 0, 0 ],
		[ 0, 0, 0, 0, 0, 0, 2, 2, 1, 1, 2, 2, 0, 0, 0, 0, 0, 0 ],
		[ 0, 0, 0, 0, 0, 0, 2, 2, 1, 1, 2, 2, 2, 0, 0, 0, 0, 0 ],
		[ 0, 0, 0, 0, 2, 2, 2, 1, 1, 1, 1, 2, 2, 2, 0, 0, 0, 0 ],
		[ 0, 0, 0, 2, 2, 2, 1, 1, 1, 1, 1, 1, 2, 2, 2, 0, 0, 0 ],
		[ 0, 0, 2, 2, 1, 1, 1, 1, 1, 1, 2, 1, 1, 1, 2, 2, 0, 0 ],
		[ 0, 0, 2, 2, 1, 1, 1, 1, 1, 1, 2, 2, 1, 1, 1, 2, 2, 0 ],
		[ 0, 0, 2, 2, 1, 1, 1, 1, 1, 1, 1, 2, 2, 1, 1, 2, 2, 0 ],
	 	[ 2, 2, 2, 2, 1, 1, 1, 1, 1, 1, 1, 1, 1, 1, 1, 2, 2, 2 ],
	 	[ 0, 1, 1, 1, 1, 1, 1, 1, 1, 1, 1, 1, 1, 1, 1, 1, 1, 0 ],
	 	[ 0, 1, 1, 1, 1, 1, 1, 1, 1, 1, 1, 1, 1, 1, 1, 1, 1, 0 ],
	 	[ 2, 2, 2, 1, 1, 1, 1, 1, 1, 2, 2, 1, 1, 1, 1, 2, 2, 2 ],
	 	[ 0, 0, 2, 2, 1, 1, 1, 1, 2, 2, 2, 1, 1, 1, 1, 2, 2, 0 ],
		[ 0, 0, 0, 2, 2, 1, 1, 1, 2, 2, 1, 1, 1, 1, 2, 2, 0, 0 ],
	 	[ 0, 0, 0, 0, 2, 2, 1, 1, 1, 1, 1, 1, 1, 2, 2, 0, 0, 0 ],
	 	[ 0, 0, 0, 0, 0, 2, 2, 2, 2, 2, 2, 2, 2, 2, 0, 0, 0, 0 ],
	 	[ 0, 0, 0, 0, 0, 0, 2, 2, 2, 2, 2, 2, 2, 0, 0, 0, 0, 0 ],
		[ 0, 0, 0, 0, 0, 0, 0, 0, 0, 0, 0, 0, 0, 0, 0, 0, 0, 0 ],
		[ 0, 0, 0, 0, 0, 0, 0, 0, 0, 0, 0, 0, 0, 0, 0, 0, 0, 0 ]
	]
}
